**************************
*         *       *   * E*
*  * **** *  ****** * *  *
*  *    * *       * * *  *
*  ***  * *  *    * *    *
*    *  ***  *  *** * *  *
*S   *       *      * *  *
**************************